20
#####################
##         B   ######
#                   #
#                   #
#P      *   *       #
#         *         #
####             V  #
###      H   ########
# >                 #
#####################
