200
#####################
####       B  *######
#  x                #
#         *         #
#P      *  *      I #
#         *         #
####                #
###C         ########
# >                 #
#####################
