36
###################
#************ @   #
#        P######  #
########      #####
#          #      #
# ######          #
#           B     #
# #####+  #########
#     >   ##  @   #
###################
