123
##########################
#@**#                    #
#***#     B              #
#***#                  # #
#***# ***************** *#
#***#                  I #
#***#################    #
#**&             **      #
#P*##    >         ***  @#
##########################
