1000
##########################
#@**#                    #
#***#     B              #
#***#                  # #
#***# ***************** *#
#***#                  I #
#***#################    #
#***#C             **    #
#P**#    >       x ***  @#
##########################
