20
###################################
#>#########*###########*###########
# ######### ###########*###########
#+######### ###########*###########
# #########     C      *###########
# ######### ########### ###########
# #########P########### ###########
###################################
