50
###############
##> ######  C #
#+       #    #
#   H#####   ##
#        #    #
#I  ######    #
#     V  #  * #
###############
