20
#####################
##         B   ######
#                   #
#                   #
#P      *   *       #
#         *         #
####             V  #
###>     H   ########
#           x  +    #
#####################
