100
##################
#       #        #
#       I #      #
#        &#      #
# >      &#      #
#              * #
################## 
